Tube#,Indivudal,T5,T6,T7,Sum,
1,1,3,5,4,12,
1,2,2,4,1,7,
1,3,3,6,1,10,
1,4,2,4,2,8,
1,5,3,5,2,10,
1,6,2,4,2,8,
1,7,1,4,2,7,
1,8,2,3,2,7,
1,9,2,6,2,10,
1,10,2,5,4,11,
1,11,1,3,3,7,
1,12,1,2,2,5,
1,13,2,7,2,11,
1,14,2,5,2,9,
1,15,1,3,1,5,
1,16,1,6,4,11,
1,17,1,1,0,2,
1,18,2,6,2,10,
1,19,1,4,2,7,
1,20,2,4,1,7,
1,21,3,5,4,12,
1,22,1,3,0,4,
1,23,1,2,3,6,
1,24,1,2,1,4,
1,25,2,8,3,13,
1,26,2,4,0,6,
1,27,3,4,3,10,
1,28,2,5,2,9,
1,29,1,3,1,5,
1,30,2,3,0,5,
2,1,2,6,4,12,
2,2,2,4,2,8,
2,3,1,3,1,5,
2,4,2,7,5,14,
2,5,2,5,5,12,
2,6,2,3,2,7,
2,7,2,5,2,9,
2,8,2,5,3,10,
2,9,2,4,2,8,
2,10,2,5,3,10,
2,11,2,4,2,8,
2,12,2,3,2,7,
2,13,1,5,2,8,
2,14,2,3,2,7,
2,15,2,5,2,9,
2,16,1,2,1,4,
2,17,1,2,1,4,
2,18,2,4,4,10,
2,19,2,4,3,9,
2,20,2,5,2,9,
2,21,2,5,6,13,
2,22,2,4,2,8,
2,23,1,6,6,13,
2,24,2,3,4,9,
2,25,2,3,4,9,
2,26,2,6,5,13,
2,27,3,6,3,12,
2,28,1,5,3,9,
2,29,1,3,0,4,
2,30,3,7,6,16,
3,1,3,6,2,11,
3,2,2,4,2,8,
3,3,3,8,3,14,
3,4,3,6,4,13,
3,5,3,4,1,8,
3,6,2,6,5,13,
3,7,1,2,3,6,
3,8,2,8,1,11,
3,9,2,9,2,13,
3,10,3,7,3,13,
3,11,2,6,1,9,
3,12,2,4,1,7,
3,13,2,6,0,8,
3,14,2,3,3,8,
3,15,3,9,3,15,
3,16,2,3,3,8,
3,17,4,10,4,18,
3,18,2,3,1,6,
3,19,2,7,2,11,
3,20,3,6,4,13,
3,21,3,9,2,14,
3,22,3,6,4,13,
3,23,2,5,5,12,
3,24,2,3,0,5,
3,25,2,8,1,11,
3,26,2,6,3,11,
3,27,5,9,7,21,
3,28,1,5,1,7,
3,29,1,3,2,6,
3,30,3,10,2,15,
4,1,1,1,1,3,
4,2,1,2,0,3,
4,3,2,3,1,6,
4,4,1,0,0,1,
4,5,1,3,2,6,
4,6,2,4,1,7,
4,7,1,2,1,4,
4,8,1,2,1,4,
4,9,1,1,0,2,
4,10,1,1,0,2,
4,11,1,4,2,7,
4,12,2,3,0,5,
4,13,3,3,3,9,
4,14,2,3,0,5,
4,15,1,3,2,6,
4,16,2,7,6,15,
4,17,2,4,3,9,
4,18,2,2,1,5,
4,19,2,7,5,14,
4,20,3,9,5,17,
4,21,1,2,1,4,
4,22,4,6,0,10,
4,23,1,2,1,4,
4,24,1,3,0,4,
4,25,1,1,1,3,
4,26,2,2,1,5,
4,27,1,1,1,3,
4,28,2,3,0,5,
4,29,2,4,4,10,
4,30,2,3,2,7,
5,1,2,3,0,5,
5,2,1,3,2,6,
5,3,4,6,2,12,
5,4,1,3,1,5,
5,5,4,10,4,18,
5,6,2,6,2,10,
5,7,2,4,1,7,
5,8,2,4,2,8,
5,9,3,4,6,13,
5,10,3,8,1,12,
5,11,1,2,1,4,
5,12,2,4,3,9,
5,13,2,4,1,7,
5,14,3,9,5,17,
5,15,3,8,3,14,
5,16,1,1,1,3,
5,17,1,4,1,6,
5,18,2,6,4,12,
5,19,2,2,2,6,
5,20,2,9,4,15,
5,21,2,9,7,18,
5,22,2,2,2,6,
5,23,2,4,2,8,
5,24,2,2,2,6,
5,25,2,3,1,6,
5,26,2,4,1,7,
5,27,2,4,1,7,
5,28,2,3,0,5,
5,29,2,4,3,9,
5,30,1,5,4,10,
6,1,2,6,1,9,
6,2,1,7,3,11,
6,3,3,10,2,15,
6,4,2,4,3,9,
6,5,1,1,0,2,
6,6,2,4,3,9,
6,7,3,8,2,13,
6,8,2,6,1,9,
6,9,2,4,1,7,
6,10,2,3,0,5,
6,11,1,2,1,4,
6,12,1,3,0,4,
6,13,1,8,1,10,
6,14,2,3,3,8,
6,15,2,2,1,5,
6,16,2,5,3,10,
6,17,2,3,0,5,
6,18,2,2,1,5,
6,19,3,7,2,12,
6,20,3,8,2,13,
6,21,1,3,2,6,
6,22,1,6,2,9,
6,23,1,3,2,6,
6,24,2,8,2,12,
6,25,2,4,1,7,
6,26,2,5,7,14,
6,27,3,5,0,8,
6,28,1,3,2,6,
6,29,1,8,5,14,
6,30,3,6,4,13,
7,1,1,3,0,4,
7,2,2,7,2,11,
7,3,2,3,2,7,
7,4,1,9,2,12,
7,5,2,7,6,15,
7,6,2,4,1,7,
7,7,3,9,8,20,
7,8,2,5,5,12,
7,9,2,4,3,9,
7,10,2,3,0,5,
7,11,1,6,1,8,
7,12,2,6,4,12,
7,13,1,5,3,9,
7,14,2,3,3,8,
7,15,1,3,3,7,
7,16,1,1,0,2,
7,17,2,3,0,5,
7,18,2,4,1,7,
7,19,3,9,8,20,
7,20,4,8,4,16,
7,21,1,1,1,3,
7,22,3,6,3,12,
7,23,2,9,10,21,
7,24,2,2,1,5,
7,25,3,5,3,11,
7,26,1,1,0,2,
7,27,1,2,0,3,
7,28,5,10,4,19,
7,29,3,8,5,16,
7,30,2,4,2,8,
8,1,1,2,0,3,
8,2,2,5,2,9,
8,3,2,4,1,7,
8,4,1,2,1,4,
8,5,2,4,1,7,
8,6,1,3,3,7,
8,7,2,5,4,11,
8,8,1,3,1,5,
8,9,1,3,3,7,
8,10,2,2,0,4,
8,11,2,3,4,9,
8,12,2,4,1,7,
8,13,1,4,1,6,
8,14,2,3,1,6,
8,15,1,3,2,6,
8,16,2,3,1,6,
8,17,2,2,0,4,
8,18,1,2,4,7,
8,19,2,3,0,5,
8,20,1,4,2,7,
8,21,3,8,8,19,
8,22,2,2,2,6,
8,23,1,1,1,3,
8,24,1,2,0,3,
8,25,2,5,2,9,
8,26,2,5,1,8,
8,27,1,3,1,5,
8,28,2,8,4,14,
8,29,1,2,1,4,
8,30,1,2,0,3,
9,1,2,8,2,12,
9,2,2,3,4,9,
9,3,2,6,3,11,
9,4,2,5,5,12,
9,5,1,2,0,3,
9,6,2,5,3,10,
9,7,1,2,0,3,
9,8,2,2,1,5,
9,9,2,2,0,4,
9,10,3,9,3,15,
9,11,2,8,6,16,
9,12,1,3,2,6,
9,13,1,4,4,9,
9,14,2,5,1,8,
9,15,1,2,1,4,
9,16,2,6,6,14,
9,17,1,3,1,5,
9,18,2,4,3,9,
9,19,2,8,5,15,
9,20,2,3,1,6,
9,21,3,3,2,8,
9,22,2,4,2,8,
9,23,1,3,2,6,
9,24,1,2,2,5,
9,25,2,5,4,11,
9,26,1,2,0,3,
9,27,1,2,2,5,
9,28,2,4,2,8,
9,29,1,1,0,2,
9,30,1,6,5,12,
10,1,2,3,1,6,
10,2,1,9,2,12,
10,3,2,2,1,5,
10,4,1,1,0,2,
10,5,2,7,0,9,
10,6,2,2,2,6,
10,7,2,3,0,5,
10,8,2,4,1,7,
10,9,1,2,0,3,
10,10,1,2,0,3,
10,11,2,7,2,11,
10,12,2,4,2,8,
10,13,1,3,1,5,
10,14,2,7,4,13,
10,15,1,2,0,3,
10,16,2,3,1,6,
10,17,2,4,1,7,
10,18,1,2,1,4,
10,19,2,7,1,10,
10,20,1,2,0,3,
10,21,1,3,2,6,
10,22,2,2,0,4,
10,23,1,5,2,8,
10,24,1,1,0,2,
10,25,2,3,0,5,
10,26,2,4,2,8,
10,27,1,1,0,2,
10,28,1,7,4,12,
10,29,4,9,4,17,
10,30,1,2,0,3,
11,1,3,5,4,12,
11,2,2,8,5,15,
11,3,1,4,4,9,
11,4,3,8,5,16,
11,5,2,4,3,9,
11,6,1,3,3,7,
11,7,2,5,3,10,
11,8,1,4,2,7,
11,9,1,6,2,9,
11,10,2,5,4,11,
11,11,2,7,2,11,
11,12,1,2,1,4,
11,13,2,5,3,10,
11,14,1,2,1,4,
11,15,1,3,1,5,
11,16,1,7,3,11,
11,17,2,7,6,15,
11,18,2,4,6,12,
11,19,2,4,3,9,
11,20,2,7,2,11,
11,21,1,4,2,7,
11,22,1,3,2,6,
11,23,1,2,1,4,
11,24,2,7,2,11,
11,25,2,4,3,9,
11,26,1,6,6,13,
11,27,1,3,2,6,
11,28,2,4,2,8,
11,29,1,3,1,5,
11,30,2,4,2,8,
12,1,3,8,2,13,
12,2,2,9,4,15,
12,3,1,5,5,11,
12,4,2,5,5,12,
12,5,3,9,2,14,
12,6,1,3,1,5,
12,7,2,8,3,13,
12,8,2,5,4,11,
12,9,1,5,4,10,
12,10,1,6,1,8,
12,11,2,4,2,8,
12,12,1,3,1,5,
12,13,2,4,3,9,
12,14,1,6,3,10,
12,15,2,8,3,13,
12,16,1,5,2,8,
12,17,2,5,2,9,
12,18,1,4,2,7,
12,19,2,9,1,12,
12,20,2,5,1,8,
12,21,2,5,4,11,
12,22,2,5,1,8,
12,23,2,4,3,9,
12,24,2,8,2,12,
12,25,1,6,2,9,
12,26,1,3,1,5,
12,27,2,2,0,4,
12,28,1,4,3,8,
12,29,2,3,6,11,
12,30,1,2,1,4,
13,1,,,,0,
13,2,,,,0,
13,3,,,,0,
13,4,,,,0,
13,5,,,,0,
13,6,,,,0,
13,7,,,,0,
13,8,,,,0,
13,9,,,,0,
13,10,,,,0,
13,11,,,,0,
13,12,,,,0,
13,13,,,,0,
13,14,,,,0,
13,15,,,,0,
13,16,,,,0,
13,17,,,,0,
13,18,,,,0,
13,19,,,,0,
13,20,,,,0,
13,21,,,,0,
13,22,,,,0,
13,23,,,,0,
13,24,,,,0,
13,25,,,,0,
13,26,,,,0,
13,27,,,,0,
13,28,,,,0,
13,29,,,,0,
13,30,,,,0,
14,1,1,3,0,4,
14,2,1,4,2,7,
14,3,2,2,0,4,
14,4,1,4,2,7,
14,5,1,3,3,7,
14,6,1,2,2,5,
14,7,1,2,1,4,
14,8,2,1,1,4,
14,9,1,3,1,5,
14,10,2,2,3,7,
14,11,1,2,1,4,
14,12,1,3,1,5,
14,13,1,2,0,3,
14,14,1,3,3,7,
14,15,1,3,3,7,
14,16,2,6,4,12,
14,17,1,2,1,4,
14,18,1,2,1,4,
14,19,1,1,0,2,
14,20,1,3,3,7,
14,21,2,4,2,8,
14,22,1,3,2,6,
14,23,1,3,2,6,
14,24,1,3,2,6,
14,25,2,2,0,4,
14,26,1,1,1,3,
14,27,1,4,3,8,
14,28,1,1,0,2,
14,29,2,6,4,12,
14,30,2,3,2,7,
15,1,1,3,1,5,
15,2,1,4,2,7,
15,3,1,2,2,5,
15,4,2,3,1,6,
15,5,1,5,6,12,
15,6,2,6,4,12,
15,7,1,2,1,4,
15,8,2,4,3,9,
15,9,2,4,2,8,
15,10,1,7,4,12,
15,11,1,3,0,4,
15,12,1,4,2,7,
15,13,3,8,7,18,
15,14,1,5,4,10,
15,15,1,5,2,8,
15,16,2,8,4,14,
15,17,2,5,3,10,
15,18,2,5,4,11,
15,19,2,4,4,10,
15,20,1,3,2,6,
15,21,1,6,1,8,
15,22,2,5,1,8,
15,23,2,3,1,6,
15,24,1,2,2,5,
15,25,2,6,8,16,
15,26,2,7,5,14,
15,27,1,2,0,3,
15,28,1,4,2,7,
15,29,2,8,4,14,
15,30,1,1,1,3,
16,1,1,8,4,13,
16,2,1,6,0,7,
16,3,2,6,2,10,
16,4,2,5,2,9,
16,5,2,4,1,7,
16,6,1,2,0,3,
16,7,2,5,1,8,
16,8,1,2,1,4,
16,9,1,1,1,3,
16,10,1,3,0,4,
16,11,2,6,3,11,
16,12,2,4,3,9,
16,13,1,4,2,7,
16,14,1,4,1,6,
16,15,1,3,1,5,
16,16,1,5,1,7,
16,17,1,2,1,4,
16,18,2,4,1,7,
16,19,1,2,1,4,
16,20,1,3,1,5,
16,21,2,5,3,10,
16,22,2,6,3,11,
16,23,1,1,1,3,
16,24,2,5,2,9,
16,25,1,2,1,4,
16,26,1,0,0,1,
16,27,2,3,1,6,
16,28,2,6,2,10,
16,29,1,3,1,5,
16,30,1,5,1,7,
17,1,2,4,1,7,
17,2,2,9,3,14,
17,3,2,3,2,7,
17,4,2,4,2,8,
17,5,2,8,2,12,
17,6,2,8,7,17,
17,7,1,2,1,4,
17,8,2,2,2,6,
17,9,2,2,1,5,
17,10,2,4,3,9,
17,11,1,8,5,14,
17,12,1,6,2,9,
17,13,1,3,1,5,
17,14,2,4,1,7,
17,15,2,5,3,10,
17,16,2,8,2,12,
17,17,2,7,8,17,
17,18,2,3,1,6,
17,19,2,8,5,15,
17,20,2,3,2,7,
17,21,1,3,2,6,
17,22,3,9,8,20,
17,23,2,8,2,12,
17,24,1,8,6,15,
17,25,1,4,2,7,
17,26,1,2,1,4,
17,27,1,3,1,5,
17,28,2,5,2,9,
17,29,1,4,1,6,
17,30,2,2,1,5,
18,1,3,5,2,10,
18,2,2,7,2,11,
18,3,1,2,0,3,
18,4,1,7,8,16,
18,5,2,8,2,12,
18,6,2,9,3,14,
18,7,1,3,2,6,
18,8,1,1,1,3,
18,9,1,3,0,4,
18,10,1,2,0,3,
18,11,2,6,2,10,
18,12,2,6,2,10,
18,13,1,2,1,4,
18,14,1,3,3,7,
18,15,1,1,0,2,
18,16,2,7,2,11,
18,17,1,5,2,8,
18,18,2,4,2,8,
18,19,1,3,1,5,
18,20,1,3,2,6,
18,21,1,2,1,4,
18,22,2,3,3,8,
18,23,1,8,3,12,
18,24,2,4,0,6,
18,25,1,3,3,7,
18,26,1,2,1,4,
18,27,1,2,1,4,
18,28,3,9,6,18,
18,29,1,2,3,6,
18,30,2,6,3,11,
19,1,2,7,2,11,
19,2,1,3,3,7,
19,3,2,4,2,8,
19,4,2,3,1,6,
19,5,2,5,2,9,
19,6,2,4,2,8,
19,7,1,4,3,8,
19,8,2,4,3,9,
19,9,3,8,2,13,
19,10,2,7,2,11,
19,11,2,10,6,18,
19,12,1,2,2,5,
19,13,2,4,2,8,
19,14,2,6,2,10,
19,15,2,6,1,9,
19,16,2,4,3,9,
19,17,1,7,1,9,
19,18,2,6,2,10,
19,19,3,8,7,18,
19,20,1,9,5,15,
19,21,2,4,2,8,
19,22,2,5,3,10,
19,23,2,5,3,10,
19,24,2,2,1,5,
19,25,2,7,3,12,
19,26,2,4,2,8,
19,27,2,5,2,9,
19,28,2,4,3,9,
19,29,1,3,2,6,
19,30,2,5,1,8,
20,1,1,1,0,2,
20,2,3,10,2,15,
20,3,3,5,3,11,
20,4,1,2,1,4,
20,5,1,3,1,5,
20,6,2,5,4,11,
20,7,2,6,8,16,
20,8,3,7,3,13,
20,9,2,6,2,10,
20,10,1,2,2,5,
20,11,2,3,2,7,
20,12,2,2,1,5,
20,13,2,5,1,8,
20,14,2,7,5,14,
20,15,2,3,2,7,
20,16,1,3,2,6,
20,17,2,3,1,6,
20,18,2,2,2,6,
20,19,1,2,0,3,
20,20,2,6,3,11,
20,21,2,4,2,8,
20,22,3,7,4,14,
20,23,1,2,0,3,
20,24,2,3,4,9,
20,25,1,2,1,4,
20,26,3,3,1,7,
20,27,1,6,5,12,
20,28,2,4,3,9,
20,29,1,6,0,7,
20,30,1,1,0,2,
21,1,1,5,5,11,
21,2,2,5,3,10,
21,3,1,1,0,2,
21,4,2,7,3,12,
21,5,2,7,6,15,
21,6,2,6,5,13,
21,7,2,5,3,10,
21,8,1,2,3,6,
21,9,2,6,5,13,
21,10,1,9,4,14,
21,11,3,5,5,13,
21,12,1,3,7,11,
21,13,1,3,2,6,
21,14,2,8,7,17,
21,15,2,7,2,11,
21,16,2,7,6,15,
21,17,1,2,1,4,
21,18,2,3,2,7,
21,19,2,5,5,12,
21,20,1,6,4,11,
21,21,2,3,3,8,
21,22,2,5,4,11,
21,23,1,1,0,2,
21,24,2,7,8,17,
21,25,2,2,0,4,
21,26,3,6,5,14,
21,27,2,7,7,16,
21,28,2,3,2,7,
21,29,2,6,5,13,
21,30,2,1,0,3,
22,1,2,3,4,9,
22,2,1,2,0,3,
22,3,2,9,3,14,
22,4,1,2,1,4,
22,5,1,1,1,3,
22,6,2,4,1,7,
22,7,1,3,0,4,
22,8,1,1,0,2,
22,9,2,3,2,7,
22,10,3,4,1,8,
22,11,1,4,3,8,
22,12,2,4,3,9,
22,13,1,3,2,6,
22,14,1,3,0,4,
22,15,1,3,1,5,
22,16,2,3,0,5,
22,17,1,6,1,8,
22,18,1,6,2,9,
22,19,3,5,3,11,
22,20,1,2,2,5,
22,21,1,2,1,4,
22,22,2,8,5,15,
22,23,1,1,3,5,
22,24,1,4,2,7,
22,25,1,3,1,5,
22,26,2,5,1,8,
22,27,1,1,0,2,
22,28,1,1,0,2,
22,29,2,6,5,13,
22,30,2,4,0,6,
23,1,2,8,6,16,
23,2,2,3,0,5,
23,3,2,7,2,11,
23,4,2,3,1,6,
23,5,2,3,1,6,
23,6,3,8,9,20,
23,7,1,5,2,8,
23,8,2,3,2,7,
23,9,1,1,1,3,
23,10,2,3,2,7,
23,11,2,4,1,7,
23,12,2,4,2,8,
23,13,2,6,4,12,
23,14,1,3,4,8,
23,15,2,6,8,16,
23,16,2,3,1,6,
23,17,2,8,3,13,
23,18,1,2,1,4,
23,19,2,7,2,11,
23,20,2,7,4,13,
23,21,2,3,1,6,
23,22,1,4,2,7,
23,23,1,4,2,7,
23,24,3,7,6,16,
23,25,2,5,1,8,
23,26,2,5,1,8,
23,27,2,3,4,9,
23,28,2,4,1,7,
23,29,1,6,1,8,
23,30,2,6,2,10,
24,1,2,5,1,8,
24,2,1,4,4,9,
24,3,2,2,0,4,
24,4,2,6,3,11,
24,5,2,2,1,5,
24,6,2,3,0,5,
24,7,2,7,3,12,
24,8,2,6,3,11,
24,9,1,8,4,13,
24,10,1,3,0,4,
24,11,1,5,4,10,
24,12,1,3,1,5,
24,13,1,6,3,10,
24,14,2,8,4,14,
24,15,2,4,3,9,
24,16,1,8,4,13,
24,17,2,8,3,13,
24,18,1,6,2,9,
24,19,2,3,2,7,
24,20,1,4,1,6,
24,21,2,3,2,7,
24,22,2,8,2,12,
24,23,2,9,3,14,
24,24,2,4,2,8,
24,25,1,6,5,12,
24,26,2,6,3,11,
24,27,2,4,1,7,
24,28,1,3,1,5,
24,29,1,3,3,7,
24,30,2,6,4,12,
25,1,2,5,4,11,
25,2,2,9,5,16,
25,3,2,6,3,11,
25,4,3,6,3,12,
25,5,2,6,4,12,
25,6,2,7,6,15,
25,7,2,6,5,13,
25,8,2,8,4,14,
25,9,2,3,1,6,
25,10,1,4,3,8,
25,11,2,6,4,12,
25,12,2,3,1,6,
25,13,2,6,2,10,
25,14,2,3,3,8,
25,15,3,6,4,13,
25,16,2,6,7,15,
25,17,1,3,3,7,
25,18,3,8,5,16,
25,19,2,7,4,13,
25,20,2,6,5,13,
25,21,1,2,1,4,
25,22,2,6,7,15,
25,23,2,4,3,9,
25,24,2,5,2,9,
25,25,2,6,5,13,
25,26,1,3,4,8,
25,27,3,6,3,12,
25,28,2,4,2,8,
25,29,5,5,5,15,
25,30,3,9,3,15,
26,1,1,2,1,4,
26,2,3,7,2,12,
26,3,3,6,7,16,
26,4,1,4,2,7,
26,5,2,3,2,7,
26,6,2,4,2,8,
26,7,1,5,2,8,
26,8,2,5,5,12,
26,9,1,5,3,9,
26,10,2,3,1,6,
26,11,1,5,5,11,
26,12,1,2,1,4,
26,13,2,3,1,6,
26,14,1,2,3,6,
26,15,2,6,3,11,
26,16,2,4,2,8,
26,17,2,4,4,10,
26,18,1,8,8,17,
26,19,2,6,1,9,
26,20,2,5,2,9,
26,21,1,2,0,3,
26,22,1,3,1,5,
26,23,2,3,2,7,
26,24,2,3,2,7,
26,25,1,4,4,9,
26,26,3,7,4,14,
26,27,2,4,3,9,
26,28,2,4,1,7,
26,29,2,4,2,8,
26,30,2,6,10,18,
27,1,1,3,2,6,
27,2,2,4,2,8,
27,3,2,4,3,9,
27,4,3,7,8,18,
27,5,1,5,2,8,
27,6,2,7,5,14,
27,7,2,3,2,7,
27,8,2,3,4,9,
27,9,2,3,3,8,
27,10,2,4,4,10,
27,11,2,4,2,8,
27,12,1,3,3,7,
27,13,2,2,2,6,
27,14,2,4,0,6,
27,15,1,3,1,5,
27,16,2,2,4,8,
27,17,1,1,1,3,
27,18,2,4,2,8,
27,19,1,3,0,4,
27,20,3,6,4,13,
27,21,2,7,5,14,
27,22,2,4,3,9,
27,23,2,6,3,11,
27,24,2,3,1,6,
27,25,2,5,1,8,
27,26,2,6,2,10,
27,27,1,1,1,3,
27,28,2,5,3,10,
27,29,2,7,8,17,
27,30,1,2,1,4,
28,1,2,4,5,11,
28,2,2,4,3,9,
28,3,2,6,5,13,
28,4,2,6,4,12,
28,5,1,3,2,6,
28,6,2,4,2,8,
28,7,2,8,4,14,
28,8,1,5,2,8,
28,9,2,5,2,9,
28,10,1,3,1,5,
28,11,2,4,2,8,
28,12,2,4,4,10,
28,13,2,3,4,9,
28,14,2,5,3,10,
28,15,2,4,4,10,
28,16,2,6,8,16,
28,17,1,7,6,14,
28,18,1,7,6,14,
28,19,1,4,1,6,
28,20,1,4,5,10,
28,21,2,5,4,11,
28,22,2,9,8,19,
28,23,2,6,1,9,
28,24,2,6,3,11,
28,25,1,3,3,7,
28,26,2,5,2,9,
28,27,2,5,4,11,
28,28,2,5,4,11,
28,29,1,4,5,10,
28,30,2,4,4,10,
29,1,2,8,4,14,
29,2,2,6,7,15,
29,3,2,6,3,11,
29,4,2,4,4,10,
29,5,1,4,2,7,
29,6,2,8,8,18,
29,7,3,8,4,15,
29,8,2,3,6,11,
29,9,1,2,3,6,
29,10,2,3,1,6,
29,11,2,3,2,7,
29,12,2,4,3,9,
29,13,2,6,3,11,
29,14,1,2,1,4,
29,15,2,6,2,10,
29,16,1,1,0,2,
29,17,1,3,4,8,
29,18,4,10,8,22,
29,19,2,2,1,5,
29,20,2,8,6,16,
29,21,2,2,1,5,
29,22,2,4,1,7,
29,23,2,5,1,8,
29,24,1,3,1,5,
29,25,3,5,2,10,
29,26,3,7,2,12,
29,27,2,7,3,12,
29,28,2,4,8,14,
29,29,2,3,0,5,
29,30,1,2,1,4,
30,1,2,6,7,15,
30,2,1,1,1,3,
30,3,2,3,1,6,
30,4,1,3,0,4,
30,5,2,7,3,12,
30,6,1,6,3,10,
30,7,2,3,3,8,
30,8,2,5,1,8,
30,9,2,4,2,8,
30,10,1,4,6,11,
30,11,2,3,2,7,
30,12,3,8,5,16,
30,13,2,6,7,15,
30,14,2,4,1,7,
30,15,2,6,2,10,
30,16,2,3,2,7,
30,17,2,6,6,14,
30,18,2,6,2,10,
30,19,2,4,2,8,
30,20,2,4,2,8,
30,21,2,8,3,13,
30,22,1,5,5,11,
30,23,2,6,2,10,
30,24,2,4,5,11,
30,25,2,3,1,6,
30,26,2,3,3,8,
30,27,2,5,2,9,
30,28,2,4,1,7,
30,29,2,3,0,5,
30,30,2,5,4,11,
31,1,3,5,5,13,
31,2,2,4,4,10,
31,3,1,4,3,8,
31,4,2,3,0,5,
31,5,3,4,2,9,
31,6,1,3,1,5,
31,7,2,7,5,14,
31,8,1,3,2,6,
31,9,2,5,2,9,
31,10,1,7,4,12,
31,11,2,5,4,11,
31,12,2,5,2,9,
31,13,2,5,2,9,
31,14,2,6,5,13,
31,15,2,6,6,14,
31,16,2,3,0,5,
31,17,2,3,1,6,
31,18,2,4,2,8,
31,19,2,7,2,11,
31,20,2,3,3,8,
31,21,2,4,7,13,
31,22,2,5,5,12,
31,23,2,6,4,12,
31,24,2,9,7,18,
31,25,2,2,0,4,
31,26,2,3,2,7,
31,27,2,5,3,10,
31,28,2,6,3,11,
31,29,2,5,0,7,
31,30,1,2,1,4,
32,1,1,3,3,7,
32,2,2,4,1,7,
32,3,2,5,3,10,
32,4,1,2,3,6,
32,5,3,4,4,11,
32,6,2,8,9,19,
32,7,2,6,5,13,
32,8,2,5,5,12,
32,9,2,3,3,8,
32,10,2,3,0,5,
32,11,2,4,2,8,
32,12,1,4,4,9,
32,13,2,4,4,10,
32,14,1,5,4,10,
32,15,2,6,4,12,
32,16,2,3,3,8,
32,17,2,3,4,9,
32,18,2,3,2,7,
32,19,2,5,4,11,
32,20,2,5,6,13,
32,21,2,5,3,10,
32,22,1,5,5,11,
32,23,1,6,3,10,
32,24,2,8,6,16,
32,25,1,4,2,7,
32,26,2,4,4,10,
32,27,2,5,3,10,
32,28,2,5,3,10,
32,29,2,3,2,7,
32,30,2,7,4,13,
33,1,2,6,2,10,
33,2,2,4,2,8,
33,3,1,2,0,3,
33,4,2,3,2,7,
33,5,2,2,0,4,
33,6,1,2,1,4,
33,7,2,3,2,7,
33,8,2,3,2,7,
33,9,2,6,9,17,
33,10,2,3,1,6,
33,11,1,3,1,5,
33,12,2,7,3,12,
33,13,2,7,4,13,
33,14,1,4,3,8,
33,15,2,5,1,8,
33,16,1,2,2,5,
33,17,1,3,3,7,
33,18,3,4,3,10,
33,19,2,5,4,11,
33,20,2,5,7,14,
33,21,2,6,3,11,
33,22,2,3,1,6,
33,23,1,2,0,3,
33,24,2,4,3,9,
33,25,1,7,3,11,
33,26,1,3,1,5,
33,27,1,3,2,6,
33,28,1,3,1,5,
33,29,1,4,1,6,
33,30,2,6,4,12,
34,1,2,3,1,6,
34,2,2,7,3,12,
34,3,2,7,1,10,
34,4,2,6,3,11,
34,5,3,9,4,16,
34,6,1,3,2,6,
34,7,2,6,6,14,
34,8,2,2,1,5,
34,9,2,5,2,9,
34,10,2,3,0,5,
34,11,2,3,2,7,
34,12,2,8,7,17,
34,13,2,2,3,7,
34,14,2,4,3,9,
34,15,1,2,3,6,
34,16,2,7,5,14,
34,17,2,4,3,9,
34,18,2,6,5,13,
34,19,2,4,2,8,
34,20,2,3,2,7,
34,21,1,4,4,9,
34,22,2,5,4,11,
34,23,3,8,4,15,
34,24,1,4,3,8,
34,25,2,5,3,10,
34,26,2,6,5,13,
34,27,1,9,3,13,
34,28,3,5,1,9,
34,29,2,5,2,9,
34,30,2,6,9,17,
35,1,2,4,2,8,
35,2,1,3,1,5,
35,3,1,5,5,11,
35,4,2,4,4,10,
35,5,2,3,3,8,
35,6,1,2,1,4,
35,7,1,5,6,12,
35,8,1,5,5,11,
35,9,2,6,5,13,
35,10,1,8,5,14,
35,11,2,9,2,13,
35,12,2,4,2,8,
35,13,1,3,3,7,
35,14,2,5,2,9,
35,15,1,4,2,7,
35,16,3,6,8,17,
35,17,2,4,4,10,
35,18,1,4,2,7,
35,19,2,3,1,6,
35,20,2,4,3,9,
35,21,2,6,2,10,
35,22,2,3,2,7,
35,23,1,3,2,6,
35,24,1,3,2,6,
35,25,1,6,4,11,
35,26,1,4,2,7,
35,27,3,8,6,17,
35,28,2,8,6,16,
35,29,2,4,4,10,
35,30,1,5,1,7,
36,1,1,3,2,6,
36,2,1,2,1,4,
36,3,1,2,1,4,
36,4,2,5,4,11,
36,5,3,7,3,13,
36,6,1,2,0,3,
36,7,1,1,1,3,
36,8,2,5,6,13,
36,9,2,4,3,9,
36,10,2,3,3,8,
36,11,1,2,0,3,
36,12,2,4,2,8,
36,13,2,2,1,5,
36,14,2,6,2,10,
36,15,2,9,3,14,
36,16,1,4,1,6,
36,17,1,3,2,6,
36,18,3,7,4,14,
36,19,2,5,2,9,
36,20,1,5,3,9,
36,21,1,4,4,9,
36,22,2,3,0,5,
36,23,2,6,4,12,
36,24,2,4,3,9,
36,25,2,4,2,8,
36,26,2,6,2,10,
36,27,2,7,2,11,
36,28,2,4,4,10,
36,29,3,8,3,14,
36,30,2,4,4,10,
37,1,2,7,3,12,
37,2,2,4,1,7,
37,3,1,3,4,8,
37,4,2,6,6,14,
37,5,2,9,5,16,
37,6,1,7,6,14,
37,7,2,8,7,17,
37,8,2,6,6,14,
37,9,3,8,3,14,
37,10,2,3,2,7,
37,11,2,3,2,7,
37,12,2,3,3,8,
37,13,2,7,6,15,
37,14,2,4,4,10,
37,15,2,8,5,15,
37,16,2,7,4,13,
37,17,2,4,3,9,
37,18,2,8,5,15,
37,19,2,5,0,7,
37,20,1,5,4,10,
37,21,3,8,5,16,
37,22,2,5,4,11,
37,23,1,1,0,2,
37,24,2,4,3,9,
37,25,1,3,1,5,
37,26,2,6,8,16,
37,27,1,5,3,9,
37,28,1,2,3,6,
37,29,1,7,7,15,
37,30,1,5,6,12,
38,1,1,9,4,14,
38,2,1,3,4,8,
38,3,1,3,3,7,
38,4,1,3,1,5,
38,5,2,5,5,12,
38,6,2,5,3,10,
38,7,2,6,3,11,
38,8,2,3,3,8,
38,9,2,7,2,11,
38,10,1,2,2,5,
38,11,2,3,0,5,
38,12,1,2,2,5,
38,13,2,4,1,7,
38,14,2,4,3,9,
38,15,2,4,2,8,
38,16,2,4,1,7,
38,17,1,3,1,5,
38,18,2,3,6,11,
38,19,2,5,5,12,
38,20,2,6,3,11,
38,21,2,4,3,9,
38,22,1,2,6,9,
38,23,1,2,0,3,
38,24,2,4,1,7,
38,25,2,3,3,8,
38,26,1,2,0,3,
38,27,2,6,3,11,
38,28,2,3,1,6,
38,29,2,4,4,10,
38,30,1,3,3,7,
39,1,1,1,0,2,
39,2,1,5,4,10,
39,3,2,6,5,13,
39,4,2,5,4,11,
39,5,1,2,1,4,
39,6,2,6,1,9,
39,7,2,3,3,8,
39,8,2,3,2,7,
39,9,1,3,4,8,
39,10,2,8,4,14,
39,11,2,5,5,12,
39,12,4,6,3,13,
39,13,2,5,2,9,
39,14,2,5,4,11,
39,15,2,4,2,8,
39,16,2,4,4,10,
39,17,1,3,5,9,
39,18,1,8,3,12,
39,19,1,4,3,8,
39,20,3,4,2,9,
39,21,1,3,3,7,
39,22,1,3,3,7,
39,23,2,4,2,8,
39,24,2,5,4,11,
39,25,2,3,0,5,
39,26,2,5,4,11,
39,27,2,5,6,13,
39,28,2,3,1,6,
39,29,1,3,4,8,
39,30,2,3,1,6,
40,1,1,4,3,8,
40,2,2,7,3,12,
40,3,2,3,3,8,
40,4,2,2,0,4,
40,5,3,7,3,13,
40,6,3,10,8,21,
40,7,2,3,3,8,
40,8,1,3,0,4,
40,9,2,7,3,12,
40,10,1,2,3,6,
40,11,2,3,2,7,
40,12,2,9,5,16,
40,13,2,3,2,7,
40,14,2,4,1,7,
40,15,1,2,0,3,
40,16,1,3,3,7,
40,17,2,1,1,4,
40,18,2,4,3,9,
40,19,3,8,4,15,
40,20,2,4,3,9,
40,21,1,2,1,4,
40,22,2,8,3,13,
40,23,3,10,10,23,
40,24,2,6,3,11,
40,25,2,8,8,18,
40,26,3,5,4,12,
40,27,2,3,1,6,
40,28,1,5,3,9,
40,29,2,3,2,7,
40,30,1,2,0,3,
41,1,1,2,0,3,
41,2,1,6,2,9,
41,3,2,3,1,6,
41,4,1,3,0,4,
41,5,1,5,3,9,
41,6,2,4,3,9,
41,7,2,2,0,4,
41,8,1,2,0,3,
41,9,2,5,1,8,
41,10,2,3,1,6,
41,11,2,3,1,6,
41,12,2,3,2,7,
41,13,2,3,3,8,
41,14,2,3,2,7,
41,15,1,2,0,3,
41,16,2,3,2,7,
41,17,2,6,4,12,
41,18,2,2,2,6,
41,19,2,2,1,5,
41,20,2,7,5,14,
41,21,1,3,1,5,
41,22,2,2,1,5,
41,23,2,4,4,10,
41,24,2,4,4,10,
41,25,1,4,3,8,
41,26,1,3,0,4,
41,27,2,3,1,6,
41,28,1,2,0,3,
41,29,1,1,0,2,
41,30,1,2,2,5,
42,1,2,6,6,14,
42,2,2,3,2,7,
42,3,2,5,2,9,
42,4,2,4,7,13,
42,5,2,7,5,14,
42,6,2,7,7,16,
42,7,2,3,1,6,
42,8,1,5,4,10,
42,9,2,3,3,8,
42,10,2,6,5,13,
42,11,2,6,2,10,
42,12,2,6,3,11,
42,13,2,4,2,8,
42,14,2,4,1,7,
42,15,2,4,2,8,
42,16,2,4,2,8,
42,17,1,3,1,5,
42,18,2,3,3,8,
42,19,1,4,1,6,
42,20,1,2,1,4,
42,21,3,10,8,21,
42,22,2,2,1,5,
42,23,2,3,4,9,
42,24,1,3,1,5,
42,25,2,9,6,17,
42,26,3,8,6,17,
42,27,1,2,3,6,
42,28,2,3,2,7,
42,29,2,8,7,17,
42,30,2,3,1,6,
43,1,2,6,3,11,
43,2,1,3,1,5,
43,3,2,4,3,9,
43,4,2,6,3,11,
43,5,2,4,3,9,
43,6,2,4,5,11,
43,7,2,6,4,12,
43,8,2,4,5,11,
43,9,3,9,4,16,
43,10,2,7,4,13,
43,11,2,6,6,14,
43,12,2,4,5,11,
43,13,2,6,2,10,
43,14,1,3,4,8,
43,15,1,2,1,4,
43,16,2,4,4,10,
43,17,2,3,2,7,
43,18,1,3,2,6,
43,19,2,6,3,11,
43,20,2,7,5,14,
43,21,2,3,2,7,
43,22,2,7,4,13,
43,23,3,7,8,18,
43,24,1,4,3,8,
43,25,3,8,5,16,
43,26,2,6,10,18,
43,27,2,7,7,16,
43,28,2,2,0,4,
43,29,2,5,5,12,
43,30,2,4,5,11,
44,1,3,3,0,6,
44,2,2,4,3,9,
44,3,2,4,3,9,
44,4,3,6,4,13,
44,5,2,6,4,12,
44,6,2,7,3,12,
44,7,3,7,10,20,
44,8,1,2,2,5,
44,9,2,4,9,15,
44,10,2,8,8,18,
44,11,1,4,3,8,
44,12,1,3,6,10,
44,13,1,3,6,10,
44,14,2,4,3,9,
44,15,2,4,6,12,
44,16,2,5,4,11,
44,17,2,6,4,12,
44,18,1,3,2,6,
44,19,2,5,3,10,
44,20,2,4,2,8,
44,21,3,4,4,11,
44,22,2,6,6,14,
44,23,2,8,6,16,
44,24,2,4,1,7,
44,25,2,3,4,9,
44,26,1,8,6,15,
44,27,2,6,6,14,
44,28,2,3,2,7,
44,29,2,3,2,7,
44,30,1,2,2,5,
45,1,1,4,4,9,
45,2,2,9,4,15,
45,3,2,5,3,10,
45,4,2,9,3,14,
45,5,2,7,3,12,
45,6,1,7,2,10,
45,7,2,8,8,18,
45,8,2,5,2,9,
45,9,2,9,5,16,
45,10,2,7,3,12,
45,11,1,2,3,6,
45,12,2,3,4,9,
45,13,2,8,5,15,
45,14,1,5,2,8,
45,15,2,6,4,12,
45,16,1,3,5,9,
45,17,2,6,2,10,
45,18,1,6,5,12,
45,19,1,1,1,3,
45,20,2,6,3,11,
45,21,3,8,5,16,
45,22,2,9,4,15,
45,23,2,4,2,8,
45,24,,,,0,
45,25,,,,0,
45,26,,,,0,
45,27,,,,0,
45,28,,,,0,
45,29,,,,0,
45,30,,,,0,
46,1,2,8,3,13,
46,2,3,6,2,11,
46,3,2,5,1,8,
46,4,2,4,2,8,
46,5,2,7,3,12,
46,6,2,2,3,7,
46,7,3,10,8,21,
46,8,2,6,2,10,
46,9,2,6,5,13,
46,10,1,4,3,8,
46,11,2,9,6,17,
46,12,2,1,1,4,
46,13,1,2,2,5,
46,14,2,4,5,11,
46,15,2,3,0,5,
46,16,2,6,2,10,
46,17,1,2,1,4,
46,18,2,5,5,12,
46,19,1,4,5,10,
46,20,2,6,4,12,
46,21,2,7,9,18,
46,22,2,5,2,9,
46,23,2,5,4,11,
46,24,2,3,1,6,
46,25,2,5,4,11,
46,26,1,3,3,7,
46,27,3,4,3,10,
46,28,1,3,1,5,
46,29,2,6,4,12,
46,30,2,3,4,9,
47,1,1,2,0,3,
47,2,2,4,4,10,
47,3,2,8,5,15,
47,4,1,3,1,5,
47,5,1,5,4,10,
47,6,1,3,1,5,
47,7,1,6,1,8,
47,8,2,6,3,11,
47,9,2,3,0,5,
47,10,1,6,2,9,
47,11,2,6,2,10,
47,12,2,4,4,10,
47,13,2,3,1,6,
47,14,2,8,3,13,
47,15,2,5,2,9,
47,16,2,4,2,8,
47,17,2,2,1,5,
47,18,2,5,2,9,
47,19,1,2,0,3,
47,20,3,9,7,19,
47,21,1,5,4,10,
47,22,3,6,3,12,
47,23,2,3,1,6,
47,24,2,2,1,5,
47,25,1,6,4,11,
47,26,1,3,2,6,
47,27,2,5,6,13,
47,28,2,4,2,8,
47,29,2,6,6,14,
47,30,2,6,5,13,
48,1,1,2,0,3,
48,2,1,3,1,5,
48,3,1,3,2,6,
48,4,2,4,2,8,
48,5,1,1,3,5,
48,6,2,7,3,12,
48,7,2,2,0,4,
48,8,2,5,4,11,
48,9,2,3,2,7,
48,10,2,3,2,7,
48,11,2,2,1,5,
48,12,2,3,2,7,
48,13,3,8,4,15,
48,14,1,2,0,3,
48,15,2,4,2,8,
48,16,2,8,4,14,
48,17,2,4,2,8,
48,18,2,7,8,17,
48,19,1,2,0,3,
48,20,1,3,2,6,
48,21,2,4,4,10,
48,22,1,2,0,3,
48,23,2,7,3,12,
48,24,1,5,4,10,
48,25,2,7,3,12,
48,26,2,2,2,6,
48,27,1,3,1,5,
48,28,1,3,2,6,
48,29,2,2,2,6,
48,30,2,6,5,13,
49,1,2,4,3,9,
49,2,2,5,2,9,
49,3,2,3,3,8,
49,4,2,6,2,10,
49,5,1,5,4,10,
49,6,3,8,4,15,
49,7,2,4,3,9,
49,8,2,8,5,15,
49,9,2,5,2,9,
49,10,1,4,3,8,
49,11,1,5,4,10,
49,12,2,4,4,10,
49,13,2,4,2,8,
49,14,2,6,2,10,
49,15,2,3,2,7,
49,16,1,3,2,6,
49,17,1,3,2,6,
49,18,2,4,3,9,
49,19,2,6,2,10,
49,20,1,5,7,13,
49,21,2,6,5,13,
49,22,2,3,4,9,
49,23,2,3,2,7,
49,24,1,6,5,12,
49,25,1,2,0,3,
49,26,2,4,2,8,
49,27,2,6,8,16,
49,28,2,3,2,7,
49,29,2,6,8,16,
49,30,2,2,0,4,
50,1,2,3,0,5,
50,2,1,5,2,8,
50,3,1,2,1,4,
50,4,1,5,2,8,
50,5,1,2,2,5,
50,6,1,3,2,6,
50,7,2,3,4,9,
50,8,2,5,5,12,
50,9,2,3,5,10,
50,10,1,5,0,6,
50,11,2,4,1,7,
50,12,2,2,0,4,
50,13,1,3,3,7,
50,14,1,2,2,5,
50,15,2,6,7,15,
50,16,2,2,2,6,
50,17,1,5,4,10,
50,18,1,2,0,3,
50,19,1,3,1,5,
50,20,2,4,3,9,
50,21,2,5,5,12,
50,22,1,1,0,2,
50,23,2,4,2,8,
50,24,1,3,0,4,
50,25,2,5,3,10,
50,26,2,3,3,8,
50,27,2,3,2,7,
50,28,2,4,1,7,
50,29,2,2,2,6,
50,30,2,4,2,8,
51,1,2,6,2,10,
51,2,1,1,0,2,
51,3,3,9,2,14,
51,4,2,5,3,10,
51,5,1,1,1,3,
51,6,2,2,1,5,
51,7,2,8,8,18,
51,8,2,6,3,11,
51,9,2,7,4,13,
51,10,2,2,2,6,
51,11,2,5,2,9,
51,12,2,9,3,14,
51,13,1,3,2,6,
51,14,2,4,3,9,
51,15,2,5,4,11,
51,16,1,4,3,8,
51,17,2,5,2,9,
51,18,1,3,2,6,
51,19,3,8,3,14,
51,20,2,6,6,14,
51,21,2,7,2,11,
51,22,2,1,1,4,
51,23,2,3,1,6,
51,24,1,2,1,4,
51,25,2,5,4,11,
51,26,2,2,1,5,
51,27,2,4,6,12,
51,28,2,4,3,9,
51,29,1,2,0,3,
51,30,2,3,1,6,
52,1,2,2,0,4,
52,2,2,6,7,15,
52,3,3,8,2,13,
52,4,3,7,2,12,
52,5,1,5,1,7,
52,6,2,3,3,8,
52,7,1,6,3,10,
52,8,2,5,4,11,
52,9,2,8,2,12,
52,10,2,8,3,13,
52,11,2,4,1,7,
52,12,1,3,0,4,
52,13,2,6,4,12,
52,14,2,7,5,14,
52,15,2,4,2,8,
52,16,3,9,6,18,
52,17,2,7,3,12,
52,18,2,3,1,6,
52,19,2,3,1,6,
52,20,2,4,2,8,
52,21,1,3,3,7,
52,22,1,2,3,6,
52,23,2,2,2,6,
52,24,2,8,3,13,
52,25,2,7,1,10,
52,26,1,2,22,8,2
52,27,2,4,2,8,
52,28,2,3,0,5,
52,29,2,2,0,4,
52,30,2,2,0,4,
53,1,1,4,2,7,
53,2,1,3,0,4,
53,3,1,2,0,3,
53,4,2,2,2,6,
53,5,1,4,1,6,
53,6,2,4,2,8,
53,7,2,4,3,9,
53,8,2,2,1,5,
53,9,2,3,1,6,
53,10,2,4,2,8,
53,11,2,8,5,15,
53,12,2,4,2,8,
53,13,1,2,2,5,
53,14,0,6,3,9,
53,15,1,3,2,6,
53,16,2,4,7,13,
53,17,1,4,1,6,
53,18,2,5,3,10,
53,19,1,2,1,4,
53,20,2,6,3,11,
53,21,1,4,2,7,
53,22,2,7,3,12,
53,23,1,2,0,3,
53,24,2,8,2,12,
53,25,2,4,3,9,
53,26,2,2,0,4,
53,27,2,4,3,9,
53,28,1,2,0,3,
53,29,2,5,2,9,
53,30,1,0,0,1,
54,1,1,2,1,4,
54,2,1,2,2,5,
54,3,2,5,4,11,
54,4,1,2,0,3,
54,5,1,4,2,7,
54,6,2,8,3,13,
54,7,1,9,6,16,
54,8,2,3,2,7,
54,9,1,6,3,10,
54,10,2,2,1,5,
54,11,2,4,1,7,
54,12,2,3,1,6,
54,13,2,4,2,8,
54,14,2,3,1,6,
54,15,2,2,0,4,
54,16,2,6,2,10,
54,17,2,4,4,10,
54,18,1,3,1,5,
54,19,3,9,9,21,
54,20,2,8,8,18,
54,21,2,6,4,12,
54,22,2,5,0,7,
54,23,2,5,2,9,
54,24,2,3,5,10,
54,25,1,3,1,5,
54,26,1,3,1,5,
54,27,2,3,3,8,
54,28,2,2,1,5,
54,29,1,7,1,9,
54,30,2,7,4,13,
55,1,3,5,5,13,
55,2,2,6,6,14,
55,3,2,6,3,11,
55,4,1,1,0,2,
55,5,1,4,2,7,
55,6,2,6,4,12,
55,7,2,4,2,8,
55,8,2,5,3,10,
55,9,2,4,2,8,
55,10,1,8,4,13,
55,11,2,8,3,13,
55,12,2,3,2,7,
55,13,2,5,3,10,
55,14,2,5,5,12,
55,15,2,6,2,10,
55,16,2,3,3,8,
55,17,1,4,3,8,
55,18,1,3,3,7,
55,19,1,6,8,15,
55,20,2,3,1,6,
55,21,2,9,3,14,
55,22,2,6,4,12,
55,23,2,4,2,8,
55,24,2,5,1,8,
55,25,2,5,3,10,
55,26,1,5,2,8,
55,27,2,4,2,8,
55,28,1,2,2,5,
55,29,2,3,1,6,
55,30,1,2,2,5,
56,1,2,6,3,11,
56,2,1,5,4,10,
56,3,2,3,3,8,
56,4,2,6,4,12,
56,5,2,6,4,12,
56,6,1,5,5,11,
56,7,1,5,3,9,
56,8,2,3,3,8,
56,9,1,3,1,5,
56,10,2,3,2,7,
56,11,1,5,3,9,
56,12,1,3,2,6,
56,13,1,4,1,6,
56,14,1,6,4,11,
56,15,1,2,1,4,
56,16,2,9,3,14,
56,17,2,3,3,8,
56,18,1,1,2,4,
56,19,3,6,7,16,
56,20,2,3,1,6,
56,21,2,2,2,6,
56,22,1,2,1,4,
56,23,1,2,1,4,
56,24,1,3,1,5,
56,25,2,5,4,11,
56,26,2,3,4,9,
56,27,1,5,2,8,
56,28,1,3,2,6,
56,29,1,5,2,8,
56,30,2,5,2,9,
57,1,2,4,2,8,
57,2,2,2,0,4,
57,3,2,6,9,17,
57,4,2,4,4,10,
57,5,3,5,3,11,
57,6,3,3,0,6,
57,7,2,4,2,8,
57,8,1,4,4,9,
57,9,1,2,1,4,
57,10,1,5,4,10,
57,11,1,2,1,4,
57,12,2,4,3,9,
57,13,2,7,4,13,
57,14,2,5,2,9,
57,15,1,4,4,9,
57,16,1,4,3,8,
57,17,2,3,0,5,
57,18,1,4,3,8,
57,19,2,4,1,7,
57,20,2,6,4,12,
57,21,1,1,0,2,
57,22,1,3,3,7,
57,23,1,2,2,5,
57,24,1,3,1,5,
57,25,1,3,2,6,
57,26,2,3,6,11,
57,27,3,9,4,16,
57,28,2,5,0,7,
57,29,2,6,4,12,
57,30,1,4,5,10,
58,1,1,4,3,8,
58,2,1,1,1,3,
58,3,2,2,4,8,
58,4,1,5,1,7,
58,5,2,3,0,5,
58,6,1,3,3,7,
58,7,1,3,1,5,
58,8,2,4,0,6,
58,9,2,6,4,12,
58,10,2,2,1,5,
58,11,2,4,2,8,
58,12,2,3,4,9,
58,13,2,4,3,9,
58,14,1,3,3,7,
58,15,1,3,0,4,
58,16,2,3,1,6,
58,17,1,6,6,13,
58,18,2,4,3,9,
58,19,2,7,8,17,
58,20,1,2,0,3,
58,21,1,3,5,9,
58,22,2,4,2,8,
58,23,1,5,1,7,
58,24,2,3,7,12,
58,25,1,2,1,4,
58,26,2,4,2,8,
58,27,1,2,0,3,
58,28,2,4,0,6,
58,29,1,4,3,8,
58,30,2,7,4,13,
59,1,2,4,1,7,
59,2,1,2,3,6,
59,3,2,6,2,10,
59,4,1,2,2,5,
59,5,2,5,3,10,
59,6,2,6,2,10,
59,7,1,3,1,5,
59,8,2,5,2,9,
59,9,1,4,2,7,
59,10,2,8,3,13,
59,11,2,5,5,12,
59,12,4,9,9,22,
59,13,2,4,4,10,
59,14,3,9,9,21,
59,15,2,6,4,12,
59,16,1,3,1,5,
59,17,1,4,3,8,
59,18,2,4,3,9,
59,19,2,2,1,5,
59,20,3,7,10,20,
59,21,2,4,3,9,
59,22,2,4,2,8,
59,23,2,3,2,7,
59,24,2,6,2,10,
59,25,2,3,1,6,
59,26,2,3,2,7,
59,27,1,4,4,9,
59,28,2,4,2,8,
59,29,3,7,5,15,
59,30,2,6,2,10,
60,1,3,9,8,20,
60,2,1,3,2,6,
60,3,2,6,4,12,
60,4,2,6,2,10,
60,5,1,8,3,12,
60,6,2,3,2,7,
60,7,2,5,5,12,
60,8,1,6,3,10,
60,9,1,5,6,12,
60,10,1,3,3,7,
60,11,2,5,4,11,
60,12,3,7,3,13,
60,13,3,7,8,18,
60,14,1,3,2,6,
60,15,1,2,2,5,
60,16,1,6,8,15,
60,17,2,6,5,13,
60,18,2,5,3,10,
60,19,2,6,9,17,
60,20,2,7,3,12,
60,21,2,7,3,12,
60,22,2,6,5,13,
60,23,1,5,6,12,
60,24,2,5,6,13,
60,25,2,4,5,11,
60,26,2,5,6,13,
60,27,2,5,5,12,
60,28,2,5,5,12,
60,29,1,4,1,6,
60,30,2,4,2,8,
61,1,2,6,8,16,
61,2,3,5,2,10,
61,3,1,3,3,7,
61,4,2,7,5,14,
61,5,1,3,4,8,
61,6,2,6,6,14,
61,7,2,7,3,12,
61,8,1,2,2,5,
61,9,1,4,1,6,
61,10,3,6,3,12,
61,11,2,4,4,10,
61,12,2,5,5,12,
61,13,2,6,7,15,
61,14,2,7,2,11,
61,15,2,6,5,13,
61,16,1,2,2,5,
61,17,3,7,6,16,
61,18,2,4,7,13,
61,19,2,6,4,12,
61,20,2,5,5,12,
61,21,2,8,5,15,
61,22,2,4,3,9,
61,23,1,3,2,6,
61,24,3,9,8,20,
61,25,2,4,3,9,
61,26,2,2,1,5,
61,27,2,9,3,14,
61,28,2,3,3,8,
61,29,2,3,3,8,
61,30,2,4,2,8,
62,1,1,3,1,5,
62,2,1,3,3,7,
62,3,1,1,1,3,
62,4,2,4,4,10,
62,5,1,5,6,12,
62,6,1,2,1,4,
62,7,2,5,2,9,
62,8,1,1,0,2,
62,9,1,3,2,6,
62,10,1,4,2,7,
62,11,2,6,7,15,
62,12,3,8,7,18,
62,13,1,3,2,6,
62,14,2,2,6,10,
62,15,1,4,2,7,
62,16,2,3,1,6,
62,17,1,2,2,5,
62,18,2,5,2,9,
62,19,2,3,2,7,
62,20,2,6,6,14,
62,21,1,3,3,7,
62,22,2,4,1,7,
62,23,1,3,2,6,
62,24,2,2,0,4,
62,25,1,3,3,7,
62,26,1,7,5,13,
62,27,1,4,4,9,
62,28,2,5,1,8,
62,29,1,2,1,4,
62,30,2,5,4,11,
63,1,2,6,2,10,
63,2,2,4,2,8,
63,3,2,3,2,7,
63,4,2,4,2,8,
63,5,2,7,4,13,
63,6,2,5,2,9,
63,7,1,3,0,4,
63,8,1,5,2,8,
63,9,2,6,3,11,
63,10,2,6,4,12,
63,11,2,6,5,13,
63,12,3,6,3,12,
63,13,3,8,8,19,
63,14,2,4,4,10,
63,15,2,5,3,10,
63,16,2,3,1,6,
63,17,2,4,4,10,
63,18,2,7,3,12,
63,19,3,6,3,12,
63,20,3,4,2,9,
63,21,1,2,1,4,
63,22,2,6,4,12,
63,23,2,4,3,9,
63,24,3,7,5,15,
63,25,2,5,1,8,
63,26,2,3,4,9,
63,27,2,4,1,7,
63,28,2,5,2,9,
63,29,2,4,3,9,
63,30,1,2,2,5,
64,1,2,4,3,9,
64,2,2,4,2,8,
64,3,2,5,5,12,
64,4,2,4,5,11,
64,5,1,1,0,2,
64,6,2,8,2,12,
64,7,2,4,1,7,
64,8,1,2,3,6,
64,9,2,6,5,13,
64,10,3,9,4,16,
64,11,1,4,5,10,
64,12,1,4,2,7,
64,13,2,7,6,15,
64,14,2,8,1,11,
64,15,1,1,1,3,
64,16,2,4,2,8,
64,17,2,5,3,10,
64,18,2,7,7,16,
64,19,2,9,1,12,
64,20,4,6,6,16,
64,21,2,4,5,11,
64,22,1,6,1,8,
64,23,1,5,3,9,
64,24,2,8,5,15,
64,25,2,2,0,4,
64,26,1,2,0,3,
64,27,1,4,4,9,
64,28,1,3,2,6,
64,29,2,3,0,5,
64,30,2,4,1,7,
65,1,1,5,1,7,
65,2,2,6,1,9,
65,3,2,5,5,12,
65,4,2,6,4,12,
65,5,2,4,1,7,
65,6,1,2,1,4,
65,7,1,4,3,8,
65,8,2,4,6,12,
65,9,2,5,5,12,
65,10,2,3,3,8,
65,11,1,5,5,11,
65,12,1,2,2,5,
65,13,1,2,1,4,
65,14,2,3,1,6,
65,15,2,5,3,10,
65,16,2,6,6,14,
65,17,2,3,2,7,
65,18,2,5,5,12,
65,19,2,6,3,11,
65,20,1,3,2,6,
65,21,2,5,5,12,
65,22,2,4,3,9,
65,23,2,4,6,12,
65,24,1,4,4,9,
65,25,2,3,3,8,
65,26,2,5,3,10,
65,27,2,5,9,16,
65,28,2,3,2,7,
65,29,2,5,3,10,
65,30,2,5,3,10,